h	history
s	select_idx
ic	#image_crawl


json	parse_json
random	random_line
field	split_field
line	split_line
gbk	gbk_field
utf8	utf8_field
domain	domain_field
quote	quote_field
unquote	unquote_field
unb64	unbase64_field
b64	base64_field

card	html_card
table	html_table

curve	chart_curve
pie	chart_pie
jtree	chart_tree____json
ctree	chart_tree____field

